accept = aacbeapata
add = aadb
advise = aadavaiasaea
afford = aafboarada
agree = aagaraeb
alert = aalaearata
analyse = aanaaalayasaea
announce = aanboauanacaea
answer = aanasawaeara
appear = aapbeaaara
arrange = aarbaanagaea
arrive = aarbiavaea
ask = aasaka
attach = aatbaacaha
attack = aatbaacaka
attempt = aatbeamapata
attend = aatbeanada
attract = aatbraaacata
avoid = aavaoaiada
awake = aawaaakaea
back = baaacaka
bake = baaakaea
balance = baaalaaanacaea
ban = baaana
bang = baaanaga
bat = baaata
bathe = baaatahaea
battle = baaatblaea
be = baea
beam = baeaaama
behave = baeahaaavaea
bleach = balaeaaacaha
bless = balaeasb
blind = balaianada
blow = balaoawa
blush = balauasaha
boast = baoaaasata
boil = baoaiala
bolt = baoalata
bomb = baoamaba
book = baobka
bore = baoaraea
borrow = baoarboawa
bounce = baoauanacaea
bow = baoawa
brake = baraaakaea
breathe = baraeaaatahaea
broadcast = baraoaaadacaaasata
bruise = barauaiasaea
brush = barauasaha
bump = bauamapa
bury = bauaraya
buzz = bauazb
calculate = caaalacaualaaataea
call = caaalb
carry = caaarbya
carve = caaaravaea
cause = caaauasaea
challenge = cahaaalbeanagaea
change = cahaaanagaea
charge = cahaaaragaea
chase = cahaaasaea
cheat = cahaeaaata
check = cahaeacaka
chew = cahaeawa
chop = cahaoapa
clean = calaeaaana
clear = calaeaaara
clip = calaiapa
close = calaoasaea
coach = caoaaacaha
coil = caoaiala
collect = caoalbeacata
colour = caoalaoauara
comb = caoamaba
command = caoambaanada
communicate = caoambuanaiacaaataea
compare = caoamapaaaraea
compete = caoamapaeataea
complete = caoamapalaeataea
concentrate = caoanacaeanataraaataea
concern = caoanacaearana
confess = caoanafaeasb
consider = caoanasaiadaeara
consist = caoanasaiasata
contain = caoanataaaiana
continue = caoanataianauaea
correct = caoarbeacata
cough = caoauagaha
count = caoauanata
cover = caoavaeara
crack = caraaacaka
crash = caraaasaha
cross = caraoasb
crush = carauasaha
cry = caraya
cure = cauaraea
curl = cauarala
curve = cauaravaea
cycle = cayacalaea
dam = daaama
damage = daaamaaagaea
dare = daaaraea
deceive = daeacaeaiavaea
decide = daeacaiadaea
decorate = daeacaoaraaataea
delay = daealaaaya
delight = daealaiagahata
deliver = daealaiavaeara
depend = daeapaeanada
describe = daeasacaraiabaea
deserve = daeasaearavaea
destroy = daeasataraoaya
develop = daeavaealaoapa
disappear = daiasaaapbeaaara
disapprove = daiasaaapbraoavaea
disarm = daiasaaarama
discover = daiasacaoavaeara
dislike = daiasalaiakaea
divide = daiavaiadaea
double = daoauabalaea
doubt = daoauabata
drain = daraaaiana
draw = daraaawa
dream = daraeaaama
drive = daraiavaea
drop = daraoapa
drown = daraoawana
drum = darauama
dry = daraya
dust = dauasata
embarrass = eamabaaarbaasb
employ = eamapalaoaya
empty = eamapataya
encourage = eanacaoauaraaagaea
end = eanada
enjoy = eanajaoaya
enter = eanataeara
escape = easacaaapaea
examine = eaxaaamaianaea
excite = eaxacaiataea
excuse = eaxacauasaea
exercise = eaxaearacaiasaea
exist = eaxaiasata
expand = eaxapaaanada
expect = eaxapaeacata
explain = eaxapalaaaiana
explode = eaxapalaoadaea
extend = eaxataeanada
fade = faaadaea
fail = faaaiala
fancy = faaanacaya
fasten = faaasataeana
fear = faeaaara
feel = faebla
fence = faeanacaea
fight = faiagahata
file = faialaea
find = faianada
fit = faiata
flap = falaaapa
flash = falaaasaha
float = falaoaaata
flood = falaobda
flow = falaoawa
flower = falaoawaeara
fly = falaya
follow = faoalboawa
fool = faobla
forget = faoaragaeata
found = faoauanada
frighten = faraiagahataeana
fry = faraya
gather = gaaatahaeara
gaze = gaaazaea
get = gaeata
glow = galaoawa
glue = galauaea
go = gaoa
grab = garaaaba
grate = garaaataea
grease = garaeaaasaea
greet = garaebta
grip = garaiapa
groan = garaoaaana
grow = garaoawa
guarantee = gauaaaraaanataeb
guess = gauaeasb
guide = gauaiadaea
hammer = haaambeara
handle = haaanadalaea
hang = haaanaga
happen = haaapbeana
harass = haaaraaasb
hate = haaataea
heal = haeaaala
heap = haeaaapa
heat = haeaaata
help = haealapa
hide = haiadaea
hit = haiata
hook = haobka
hop = haoapa
hope = haoapaea
hover = haoavaeara
hug = hauaga
hum = hauama
hunt = hauanata
hurry = hauarbya
identify = iadaeanataiafaya
ignore = iaganaoaraea
impress = iamaparaeasb
improve = iamaparaoavaea
include = ianacalauadaea
increase = ianacaraeaaasaea
influence = ianafalauaeanacaea
inject = ianajaeacata
instruct = ianasatarauacata
intend = ianataeanada
interest = ianataearaeasata
interfere = ianataearafaearaea
interrupt = ianataearbuapata
introduce = ianataraoadauacaea
invent = ianavaeanata
irritate = iarbiataaataea
jail = jaaaiala
jam = jaaama
jog = jaoaga
join = jaoaiana
joke = jaoakaea
judge = jauadagaea
juggle = jauagblaea
jump = jauamapa
keep = kaebpa
kick = kaiacaka
kill = kaialb
kiss = kaiasb
kneel = kanaebla
knit = kanaiata
knock = kanaoacaka
knot = kanaoata
label = laaabaeala
land = laaanada
last = laaasata
launch = laaauanacaha
learn = laeaaarana
let = laeata
level = laeavaeala
lie = laiaea
lighten = laiagahataeana
like = laiakaea
listen = laiasataeana
live = laiavaea
load = laoaaada
long = laoanaga
look = laobka
lose = laoasaea
love = laoavaea
make = maaakaea
man = maaana
manage = maaanaaagaea
march = maaaracaha
mark = maaaraka
marry = maaarbya
match = maaatacaha
matter = maaatbeara
mean = maeaaana
measure = maeaaasauaraea
meddle = maeadblaea
meet = maebta
melt = maealata
memorize = maeamaoaraiazaea
mess = maeasb
milk = maialaka
mine = maianaea
miss = maiasb
mix = maiaxa
moan = maoaaana
mourn = maoauarana
muddle = mauadblaea
nail = naaaiala
need = naebda
nest = naeasata
nod = naoada
note = naoataea
notice = naoataiacaea
number = nauamabaeara
obey = oabaeaya
object = oabajaeacata
observe = oabasaearavaea
obtain = oabataaaiana
offend = oafbeanada
offer = oafbeara
open = oapaeana
overflow = oavaearafalaoawa
owe = oawaea
own = oawana
pack = paaacaka
paddle = paaadblaea
paint = paaaianata
park = paaaraka
pass = paaasb
paste = paaasataea
pat = paaata
pause = paaauasaea
peck = paeacaka
pedal = paeadaaala
peep = paebpa
perform = paearafaoarama
permit = paearamaiata
phone = pahaoanaea
pick = paiacaka
pinch = paianacaha
pine = paianaea
place = palaaacaea
plan = palaaana
plant = palaaanata
please = palaeaaasaea
point = paoaianata
poke = paoakaea
polish = paoalaiasaha
pop = paoapa
post = paoasata
pour = paoauara
practise = paraaacataiasaea
pray = paraaaya
preach = paraeaaacaha
precede = paraeacaeadaea
prefer = paraeafaeara
prepare = paraeapaaaraea
present = paraeasaeanata
press = paraeasb
pretend = paraeataeanada
prevent = paraeavaeanata
prick = paraiacaka
print = paraianata
produce = paraoadauacaea
program = paraoagaraaama
promise = paraoamaiasaea
pull = paualb
pump = pauamapa
punch = pauanacaha
puncture = pauanacatauaraea
punish = pauanaiasaha
push = pauasaha
question = qauaeasataiaoana
queue = qauaeauaea
radiate = raaadaiaaataea
rain = raaaiana
receive = raeacaeaiavaea
recognise = raeacaoaganaiasaea
record = raeacaoarada
reduce = raeadauacaea
regret = raeagaraeata
reign = raeaiagana
relax = raealaaaxa
release = raealaeaaasaea
rely = raealaya
remember = raeamaeamabaeara
remind = raeamaianada
remove = raeamaoavaea
repair = raeapaaaiara
repeat = raeapaeaaata
replace = raeapalaaacaea
reply = raeapalaya
report = raeapaoarata
reproduce = raeaparaoadauacaea
request = raeaqauaeasata
rescue = raeasacauaea
return = raeatauarana
rhyme = rahayamaea
risk = raiasaka
rob = raoaba
rock = raoacaka
roll = raoalb
rot = raoata
ruin = rauaiana
rule = raualaea
rush = rauasaha
sack = saaacaka
satisfy = saaataiasafaya
save = saaavaea
saw = saaawa
say = saaaya
scare = sacaaaraea
scold = sacaoalada
scorch = sacaoaracaha
scrape = sacaraaapaea
scratch = sacaraaatacaha
scream = sacaraeaaama
screw = sacaraeawa
scribble = sacaraiabblaea
scrub = sacarauaba
seal = saeaaala
search = saeaaaracaha
separate = saeapaaaraaataea
settle = saeatblaea
share = sahaaaraea
shave = sahaaavaea
shiver = sahaiavaeara
shock = sahaoacaka
shop = sahaoapa
sigh = saiagaha
sign = saiagana
signal = saiaganaaala
sin = saiana
skip = sakaiapa
slap = salaaapa
slip = salaiapa
slow = salaoawa
smash = samaaasaha
smell = samaealb
smile = samaialaea
snatch = sanaaatacaha
sneeze = sanaebzaea
sniff = sanaiafb
snow = sanaoawa
soak = saoaaaka
soothe = saobtahaea
sound = saoauanada
spark = sapaaaraka
sparkle = sapaaarakalaea
spell = sapaealb
spill = sapaialb
spoil = sapaoaiala
spray = saparaaaya
sprout = saparaoauata
squash = saqauaaasaha
squeak = saqauaeaaaka
squeal = saqauaeaaala
squeezed = saqauaebzaeada
stain = sataaaiana
stamp = sataaamapa
stare = sataaaraea
start = sataaarata
stay = sataaaya
steer = sataebra
step = sataeapa
stir = sataiara
stitch = sataiatacaha
strap = sataraaapa
strengthen = sataraeanagatahaeana
stroke = sataraoakaea
stuff = satauafb
subtract = sauabataraaacata
succeed = sauacbebda
suck = sauacaka
suffer = sauafbeara
supply = sauapblaya
support = sauapboarata
surprise = sauaraparaiasaea
suspect = sauasapaeacata
switch = sawaiatacaha
talk = taaalaka
tame = taaamaea
tap = taaapa
taste = taaasataea
tease = taeaaasaea
telephone = taealaeapahaoanaea
tempt = taeamapata
test = taeasata
thaw = tahaaawa
tickle = taiacakalaea
tie = taiaea
time = taiamaea
tip = taiapa
tire = taiaraea
tour = taoauara
trade = taraaadaea
transport = taraaanasapaoarata
tremble = taraeamabalaea
trot = taraoata
trouble = taraoauabalaea
try = taraya
tumble = tauamabalaea
turn = tauarana
type = tayapaea
undress = uanadaraeasb
unfasten = uanafaaasataeana
unite = uanaiataea
unpack = uanapaaacaka
untidy = uanataiadaya
use = uasaea
vanish = vaaanaiasaha
walk = waaalaka
wander = waaanadaeara
want = waaanata
warm = waaarama
warn = waaarana
wash = waaasaha
waste = waaasataea
watch = waaatacaha
water = waaataeara
wave = waaavaea
weigh = waeaiagaha
welcome = waealacaoamaea
whine = wahaianaea
whip = wahaiapa
whirl = wahaiarala
whisper = wahaiasapaeara
whistle = wahaiasatalaea
wink = waianaka
wish = waiasaha
wobble = waoabblaea
work = waoaraka
worry = waoarbya
wrap = waraaapa
wreck = waraeacaka
wrestle = waraeasatalaea
yell = yaealb
zip = zaiapa
zoom = zaobma
